B953D13953
843C3EC47A
AFAFAFFF96
AFEF857F83
AFFFEFFFAA
A93FBFD52A
AAAFAFFFAA
AAC52D516A
AA93A93E92
C6EC46C56E

(4, 4)
(7, 7)
Pathfinder
