D15155793B
96969556C2
AFAFAFFF96
AFEF857FC3
AFFFEFFF96
853FBFD52B
A96FAFFFAA
AC550397AA
C3956C696A
D6C5555456

(4, 4)
(7, 7)
Pathfinder
